F 60,60,60
C 135,206,235
EA ./assets/textures/east.xpm
NO ./assets/textures/north.xpm
WE ./assets/textures/west.xpm
SO ./assets/textures/south.xpm

111111
1E1001
101001
100001
111111