NO ./assets/textures/north.xpm
SO ./assets/textures/south.xpm
WE ./assets/textures/west.xpm
EA ./assets/textures/east.xpm
F 60,60,60
C 135,206,235

1111111111111
1000100000001
1010101010101
1000100100001
1001101110101
100W100000001
1111111111111
1111111111111
